10, 10
1111111111
1200011111
1111000001
1111111101
1111111101
1111111101
1111111101
1000111001
1001111011
1111111311