10, 10
1111111111
1000001011
1211011111
1111011101
1111011101
1111011101
1111011101
1000011001
1000000011
1111111311