10, 10
111   1111
12    1011
1111000001
1111111101
1111111101
1111111101
1111111101
1000111001
1001111011
1111111311