12 12 
111111111111
120001111111
111100000111
111111110111
111111110111
111111110111
111111111101
101100111001
100111111011
111100111111
111111111111
111111111111